********************
*0000000000000*0000*
**0***0****0*0x0****
*000000*0000*00000**
*0*x*0**0x*0*0***0**
*0***0**0**0*000000*
*000000*0**0*0****0*
*0****0*0**0*000000*
*00*00000**0******0*
**0*0**x000000000*0*
**0*0***0******0**0*
*0000*0000000*00**0*
*0x************0**0*
*00000000000*000000*
********************
