********************
*00000000000s0*000s*
**0***0******0*0****
*000000*0000000000**
*0***0**0**0*0***0**
*0***0**0**0*000000*
*0s0000*00*0*0****0*
*0****0*0**0*0000s0*
*00*00000**0**0*****
**0*0***000000000*0*
**0*0***0******0**0*
*0000*0000000*00**0*
*0*************0**0*
*00s00000000*000000*
********************
